bären	Noun	6 months ago	
sammlung	Noun	20 hours ago	
international	Adjective	20 hours ago	
eigenes	Adjective	20 hours ago	
öffentliche	Adjective	20 hours ago	
auch	Adverb	20 hours ago	
denn	Conjunction	20 hours ago	
ich	Pronoun	20 hours ago	
nur	Adverb	20 hours ago	
sie	Pronoun	20 hours ago	
aktiv	Adjective	20 hours ago	
ihn	Pronoun	20 hours ago	
jetzt	Adverb	20 hours ago	
für	Preposition	20 hours ago	
mein	Pronoun	20 hours ago	
und	Conjunction	20 hours ago	
schlecht	Adjective	20 hours ago	
persönlich	Adjective	20 hours ago	
ist	Verb	20 hours ago	
nicht	Adverb	20 hours ago	
sehr	Adverb	20 hours ago	
wert	Adjective	20 hours ago	
sondern	Conjunction	20 hours ago	
toll	Adjective	20 hours ago	
bereit	Adjective	20 hours ago	
ihr	Pronoun	20 hours ago	
eigener	Adjective	20 hours ago	
tanzt	Verb	20 hours ago	
ausgezeichnet	Adjective	20 hours ago	
immer	Adverb	20 hours ago	
kurz	Adjective	20 hours ago	
gerne	Adverb	20 hours ago	
tatsächlich	Adjective	20 hours ago	
eigene	Adjective	20 hours ago	
zwei	Numeral	20 hours ago	
vier	Numeral	20 hours ago	
heute	Adverb	20 hours ago	
du	Pronoun	20 hours ago	
es	Pronoun	20 hours ago	
manchmal	Adverb	20 hours ago	
kinder	Noun	20 hours ago	
dort	Adverb	21 hours ago	
oben	Adverb	21 hours ago	
begeistert	Adjective	21 hours ago	
echt	Adjective	yesterday	
offene	Adjective	yesterday	
beliebt	Adjective	yesterday	
deine	Pronoun	yesterday	
wo	Adverb	yesterday	
grün	Adjective	yesterday	
wir	Pronoun	yesterday	
er	Pronoun	yesterday	
süß	Adjective	yesterday	
interessant	Adjective	yesterday	
teuer	Adjective	yesterday	
reich	Adjective	2 days ago	
film	Noun	2 days ago	
filme	Noun	2 days ago	
modelle	Noun	2 days ago	
start	Noun	2 days ago	
fünf	Numeral	2 days ago	
instrument	Noun	2 days ago	
künstler	Noun	2 days ago	
theater	Noun	2 days ago	
jedenfalls	Adverb	2 days ago	
obwohl	Conjunction	2 days ago	
ausstellung	Noun	2 days ago	
gitarre	Noun	2 days ago	
künste	Noun	2 days ago	
ihm	Pronoun	2 days ago	
aus	Preposition	2 days ago	
mit	Preposition	2 days ago	
dir	Pronoun	3 days ago	
uns	Pronoun	3 days ago	
nie	Adverb	3 days ago	
mir	Pronoun	3 days ago	
meine	Pronoun	3 days ago	
ja	Adverb	3 days ago	
schon	Adverb	3 days ago	
dass	Conjunction	3 days ago	
mich	Pronoun	3 days ago	
drei	Numeral	3 days ago	
so	Adverb	3 days ago	
je	Adverb	3 days ago	
passiert	Adjective	3 days ago	
genau	Adjective	3 days ago	
wie	Conjunction	3 days ago	
daran	Adverb	3 days ago	
gestern	Adverb	3 days ago	
dich	Pronoun	3 days ago	
zuständig	Adjective	3 days ago	
klar	Adjective	3 days ago	
mehr	Adverb	3 days ago	
oft	Adverb	3 days ago	
langsam	Adjective	3 days ago	
komisch	Adjective	3 days ago	
zurück	Adverb	4 days ago	
weg	Adverb	4 days ago	
damit	Adverb	4 days ago	
kostenlos	Adjective	4 days ago	
komplett	Adjective	4 days ago	
eindeutig	Adjective	4 days ago	
komplette	Adjective	4 days ago	
bei	Preposition	4 days ago	
rund	Adjective	4 days ago	
morgen	Adverb	4 days ago	
aufs	Preposition	4 days ago	
wahrscheinlich	Adjective	4 days ago	
notwendig	Adjective	4 days ago	
später	Adjective	4 days ago	
keinen	Determiner	4 days ago	
aber	Conjunction	4 days ago	
lange	Adjective	4 days ago	
dann	Adverb	4 days ago	
nach	Preposition	4 days ago	
zu	Preposition	4 days ago	
zufrieden	Adjective	4 days ago	
etwas	Pronoun	5 days ago	
solange	Conjunction	5 days ago	
niemals	Adverb	5 days ago	
spieler	Noun	5 days ago	
willkommen	Adjective	5 days ago	
groß	Adjective	5 days ago	
stark	Adjective	5 days ago	
gesund	Adjective	5 days ago	
dabei	Adverb	5 days ago	
schnell	Adjective	6 days ago	
zu	Adverb	6 days ago	
frau	Noun	6 days ago	
nett	Adjective	6 days ago	
klein	Adjective	6 days ago	
oder	Conjunction	6 days ago	
männer	Noun	6 days ago	
viel	Determiner	6 days ago	
spät	Adjective	6 days ago	
zusammen	Adverb	6 days ago	
bitte	Adverb	6 days ago	
milch	Noun	6 days ago	
spiel	Noun	6 days ago	
wieder	Adverb	6 days ago	
da	Adverb	6 days ago	
niemand	Determiner	1 week ago	
zeitung	Noun	1 week ago	
bisher	Adverb	1 week ago	
salzig	Adjective	1 week ago	
habe	Verb	1 week ago	
fußball	Noun	1 week ago	
ruhig	Adjective	1 week ago	
deutsch	Noun	1 week ago	
mehr	Determiner	1 week ago	
sieben	Numeral	1 week ago	
knapp	Adjective	1 week ago	
kaputt	Adjective	1 week ago	
draußen	Adverb	1 week ago	
als	Conjunction	1 week ago	
darüber	Adverb	1 week ago	
sofort	Adverb	1 week ago	
dafür	Adverb	1 week ago	
euch	Pronoun	1 week ago	
hier	Adverb	1 week ago	
nun	Adverb	1 week ago	
deshalb	Adverb	1 week ago	
danach	Adverb	1 week ago	
noch	Adverb	1 week ago	
wann	Adverb	1 week ago	
davon	Adverb	1 week ago	
einfach	Adjective	1 week ago	
stärker	Adjective	1 week ago	
kleiner	Adjective	1 week ago	
hunger	Noun	1 week ago	
bist	Verb	1 week ago	
jungen	Noun	1 week ago	
blau	Adjective	1 week ago	
junge	Noun	1 week ago	
am	Preposition	1 week ago	
brot	Noun	1 week ago	
enten	Noun	1 week ago	
rechts	Adverb	1 week ago	
neu	Adjective	1 week ago	
links	Adverb	1 week ago	
billig	Adjective	1 week ago	
wenn	Conjunction	1 week ago	
nein	Adverb	1 week ago	
von	Preposition	1 week ago	
bald	Adverb	1 week ago	
verschiedenen	Adjective	1 week ago	
gut	Adjective	1 week ago	
höher	Adjective	1 week ago	
haben	Verb	1 week ago	
besser	Adjective	1 week ago	
doch	Conjunction	1 week ago	
wichtig	Adjective	1 week ago	
gratis	Adverb	1 week ago	
darum	Adverb	1 week ago	
guten abend		1 week ago	
wie geht's		1 week ago	
guten tag		1 week ago	
ähnlich	Adjective	1 week ago	
schwer	Adjective	1 week ago	
dein	Pronoun	1 week ago	
früh	Adjective	1 week ago	
womit	Adverb	1 week ago	
wofür	Adverb	1 week ago	
mann	Noun	1 week ago	
worüber	Adverb	1 week ago	
wieso	Adverb	1 week ago	
kind	Noun	1 week ago	
schön	Adjective	1 week ago	
hoch	Adjective	1 week ago	
branche	Noun	1 week ago	
dienstleistung	Noun	1 week ago	
voll	Adjective	2 weeks ago	
auftrag	Noun	2 weeks ago	
regional	Adjective	2 weeks ago	
antrag	Noun	2 weeks ago	
dokumentation	Noun	2 weeks ago	
tätigkeit	Noun	2 weeks ago	
kamera	Noun	2 weeks ago	
schauspieler	Noun	2 weeks ago	
kino	Noun	2 weeks ago	
schwarz	Adjective	2 weeks ago	
konzerte	Noun	2 weeks ago	
konzert	Noun	2 weeks ago	
tanz	Noun	2 weeks ago	
rahmen	Noun	2 weeks ago	
stil	Noun	2 weeks ago	
bühne	Noun	2 weeks ago	
mode	Noun	2 weeks ago	
vorne	Adverb	2 weeks ago	
verfügbar	Adjective	2 weeks ago	
literatur	Noun	2 weeks ago	
museum	Noun	2 weeks ago	
design	Noun	2 weeks ago	
kritik	Noun	2 weeks ago	
lied	Noun	2 weeks ago	
fotografie	Noun	2 weeks ago	
entwurf	Noun	2 weeks ago	
modell	Noun	2 weeks ago	
instrumente	Noun	2 weeks ago	
kultur	Noun	2 weeks ago	
musik	Noun	2 weeks ago	
galerie	Noun	2 weeks ago	
ausstellungen	Noun	2 weeks ago	
kunst	Noun	2 weeks ago	
musiker	Noun	2 weeks ago	
studio	Noun	2 weeks ago	
ohne	Preposition	2 weeks ago	
gelb	Adjective	2 weeks ago	
gewöhnlich	Adjective	2 weeks ago	
frei	Adjective	2 weeks ago	
pink	Adjective	2 weeks ago	
acht	Numeral	2 weeks ago	
gern geschehen		2 weeks ago	
zehn	Numeral	2 weeks ago	
sechs	Numeral	2 weeks ago	
neun	Numeral	2 weeks ago	
eins	Numeral	2 weeks ago	
schneit	Verb	2 weeks ago	
regnet	Verb	2 weeks ago	
warm	Adjective	2 weeks ago	
selten	Adjective	2 weeks ago	
praktisch	Adjective	2 weeks ago	
richtige	Adjective	2 weeks ago	
deutlich	Adjective	2 weeks ago	
gegen	Preposition	2 weeks ago	
alt	Adjective	2 weeks ago	
möglich	Adjective	2 weeks ago	
isst	Verb	2 weeks ago	
schwanger	Adjective	2 weeks ago	
verheiratet	Adjective	2 weeks ago	
höhere	Adjective	2 weeks ago	
bereits	Adverb	2 weeks ago	
nützlich	Adjective	2 weeks ago	
einmal	Adverb	2 weeks ago	
bewegungen	Noun	3 weeks ago	
schwimmbad	Noun	3 weeks ago	
wette	Noun	3 weeks ago	
freizeit	Noun	3 weeks ago	
ski	Noun	3 weeks ago	
bewegung	Noun	3 weeks ago	
mannschaft	Noun	3 weeks ago	
sieg	Noun	3 weeks ago	
zuschauer	Noun	3 weeks ago	
liga	Noun	3 weeks ago	
teilnahme	Noun	3 weeks ago	
spiele	Noun	3 weeks ago	
team	Noun	3 weeks ago	
sport	Noun	3 weeks ago	
hobby	Noun	3 weeks ago	
ball	Noun	3 weeks ago	
aktivitäten	Noun	3 weeks ago	
verhandeln	Verb	3 weeks ago	
betrieb	Noun	3 weeks ago	
branchen	Noun	3 weeks ago	
betriebe	Noun	3 weeks ago	
dienstleistungen	Noun	3 weeks ago	
bedarf	Noun	3 weeks ago	
leistungen	Noun	3 weeks ago	
ausgaben	Noun	3 weeks ago	
börse	Noun	3 weeks ago	
gründung	Noun	3 weeks ago	
produktion	Noun	3 weeks ago	
bewertung	Noun	3 weeks ago	
service	Noun	3 weeks ago	
werbung	Noun	3 weeks ago	
bezahlung	Noun	3 weeks ago	
marke	Noun	3 weeks ago	
lager	Noun	3 weeks ago	
chancen	Noun	3 weeks ago	
angebote	Noun	3 weeks ago	
messe	Noun	3 weeks ago	
chance	Noun	3 weeks ago	
anzeige	Noun	3 weeks ago	
angebot	Noun	3 weeks ago	
garantie	Noun	3 weeks ago	
tabellen	Noun	3 weeks ago	
verkauf	Noun	3 weeks ago	
lieferung	Noun	3 weeks ago	
ware	Noun	3 weeks ago	
industrie	Noun	3 weeks ago	
firma	Noun	3 weeks ago	
versicherung	Noun	3 weeks ago	
jung	Adjective	3 weeks ago	
deinen	Pronoun	3 weeks ago	
lebst	Verb	3 weeks ago	
spielst	Verb	3 weeks ago	
gebrauch	Noun	3 weeks ago	
gleiche	Adjective	3 weeks ago	
zuvor	Adverb	3 weeks ago	
wertvoll	Adjective	3 weeks ago	
anders	Adverb	3 weeks ago	
letzter	Adjective	3 weeks ago	
persönlichen	Adjective	3 weeks ago	
perfekt	Adjective	3 weeks ago	
ganz	Adverb	3 weeks ago	
wirklich	Adjective	3 weeks ago	
positiv	Adjective	3 weeks ago	
rot	Adjective	3 weeks ago	
richterinnen	Noun	3 weeks ago	
kindes	Noun	3 weeks ago	
heiß	Adjective	3 weeks ago	
offen	Adjective	3 weeks ago	
weiß	Adjective	3 weeks ago	
zum	Preposition	3 weeks ago	
leicht	Adjective	3 weeks ago	
gern	Adverb	3 weeks ago	
umsetzung	Noun	3 weeks ago	
kombination	Noun	3 weeks ago	
zustand	Noun	3 weeks ago	
einsatz	Noun	3 weeks ago	
kreis	Noun	3 weeks ago	
unbekannt	Adjective	3 weeks ago	
party	Noun	3 weeks ago	
feld	Noun	3 weeks ago	
einzelheiten	Noun	3 weeks ago	
parties	Noun	3 weeks ago	
gewicht	Noun	3 weeks ago	
paar	Determiner	3 weeks ago	
bis	Preposition	3 weeks ago	
verlauf	Noun	3 weeks ago	
anleitung	Noun	3 weeks ago	
langen	Adjective	3 weeks ago	
jährlich	Adjective	4 weeks ago	
mitteln	Noun	4 weeks ago	
vorschläge	Noun	4 weeks ago	
vorschlag	Noun	4 weeks ago	
habt	Verb	4 weeks ago	
kategorien	Noun	4 weeks ago	
menge	Noun	4 weeks ago	
liste	Noun	4 weeks ago	
unterschied	Noun	4 weeks ago	
bestimmungen	Noun	4 weeks ago	
erfahrungen	Noun	4 weeks ago	
versionen	Noun	4 weeks ago	
blick	Noun	4 weeks ago	
überblick	Noun	4 weeks ago	
felder	Noun	4 weeks ago	
referenzen	Noun	4 weeks ago	
partys	Noun	4 weeks ago	
wirkung	Noun	4 weeks ago	
stufe	Noun	4 weeks ago	
durch	Preposition	4 weeks ago	
rolle	Noun	4 weeks ago	
hintergrund	Noun	4 weeks ago	
spalte	Noun	4 weeks ago	
verwendung	Noun	4 weeks ago	
einführung	Noun	4 weeks ago	
position	Noun	4 weeks ago	
zugang	Noun	4 weeks ago	
mittel	Noun	4 weeks ago	
höhe	Noun	4 weeks ago	
länge	Noun	4 weeks ago	
kraft	Noun	4 weeks ago	
kategorie	Noun	4 weeks ago	
eigenschaften	Noun	4 weeks ago	
unterstützung	Noun	4 weeks ago	
original	Noun	4 weeks ago	
lang	Adjective	4 weeks ago	
version	Noun	4 weeks ago	
verbesserung	Noun	4 weeks ago	
bestimmung	Noun	4 weeks ago	
unterschiede	Noun	4 weeks ago	
planung	Noun	4 weeks ago	
erfahrung	Noun	4 weeks ago	
wunderbar	Adjective	1 month ago	
laut	Adjective	1 month ago	
woher	Adverb	1 month ago	
vorbei	Adverb	1 month ago	
gleich	Adjective	1 month ago	
plus	Adverb	1 month ago	
verantwortlich	Adjective	1 month ago	
minus	Preposition	1 month ago	
gesamte	Adjective	1 month ago	
natürlich	Adverb	1 month ago	
hoher	Adjective	1 month ago	
besonders	Adverb	1 month ago	
konto	Noun	1 month ago	
münze	Noun	1 month ago	
zinsen	Noun	1 month ago	
münzen	Noun	1 month ago	
zahlung	Noun	1 month ago	
richtig	Adjective	1 month ago	
einzelnen	Adjective	1 month ago	
gleich	Adverb	1 month ago	
finanzierung	Noun	1 month ago	
frist	Noun	1 month ago	
lecker	Adjective	1 month ago	
kalt	Adjective	1 month ago	
betrag	Noun	1 month ago	
rechnung	Noun	1 month ago	
falls	Conjunction	1 month ago	
bisschen	Determiner	1 month ago	
selbst	Adverb	1 month ago	
sobald	Conjunction	1 month ago	
alleine	Adverb	1 month ago	
lange	Adverb	1 month ago	
weniger	Adverb	1 month ago	
mal	Adverb	1 month ago	
darauf	Adverb	1 month ago	
selber	Adverb	1 month ago	
warum	Adverb	1 month ago	
privat	Adjective	1 month ago	
rein	Adverb	1 month ago	
allein	Adverb	1 month ago	
wären	Verb	1 month ago	
hätten	Verb	1 month ago	
dünn	Adjective	1 month ago	
vielleicht	Adverb	1 month ago	
wunderschön	Adjective	1 month ago	
zur	Preposition	1 month ago	
geist	Noun	1 month ago	
mindestens	Adverb	1 month ago	
unsichtbar	Adjective	1 month ago	
da	Conjunction	1 month ago	
gefühlen	Noun	1 month ago	
lebens	Noun	1 month ago	
sinne	Noun	1 month ago	
seele	Noun	1 month ago	
leben	Noun	1 month ago	
neue	Adjective	1 month ago	
hoffnung	Noun	1 month ago	
meditiere	Verb	1 month ago	
schicksal	Noun	1 month ago	
wahrheit	Noun	1 month ago	
gleichgewicht	Noun	1 month ago	
meditieren	Verb	1 month ago	
gefühl	Noun	1 month ago	
sinn	Noun	1 month ago	
seelen	Noun	1 month ago	
wunder	Noun	1 month ago	
spiritualität	Noun	1 month ago	
täglich	Adjective	1 month ago	
passende	Adjective	1 month ago	
gesamten	Adjective	1 month ago	
speziellen	Adjective	1 month ago	
vergangenen	Adjective	1 month ago	
weiteres	Adjective	1 month ago	
überall	Adverb	1 month ago	
englisch	Noun	1 month ago	
ehrlich	Adjective	1 month ago	
sogar	Adverb	1 month ago	
nächsten	Adjective	1 month ago	
außerdem	Adverb	1 month ago	
gar	Adverb	1 month ago	
schlimm	Adjective	1 month ago	
leer	Adjective	1 month ago	
essen	Verb	1 month ago	
dick	Adjective	1 month ago	
schöne	Adjective	1 month ago	
her	Adverb	1 month ago	
herum	Adverb	1 month ago	
hinaus	Adverb	1 month ago	
hin	Adverb	1 month ago	
voraus	Adverb	1 month ago	
vom	Preposition	1 month ago	
hierher	Adverb	1 month ago	
oberschenkel	Noun	1 month ago	
muskeln	Noun	1 month ago	
darm	Noun	1 month ago	
organ	Noun	1 month ago	
schwach	Adjective	1 month ago	
endlich	Adverb	1 month ago	
soweit	Adverb	1 month ago	
interessante	Adjective	1 month ago	
ellbogen	Noun	1 month ago	
ferse	Noun	1 month ago	
bäuche	Noun	1 month ago	
stirn	Noun	1 month ago	
gehirn	Noun	1 month ago	
lungen	Noun	1 month ago	
normalerweise	Adverb	1 month ago	
muskel	Noun	1 month ago	
knochen	Noun	1 month ago	
därme	Noun	1 month ago	
leber	Noun	1 month ago	
organe	Noun	1 month ago	
hüften	Noun	1 month ago	
zehen	Noun	1 month ago	
hüfte	Noun	1 month ago	
zeh	Noun	1 month ago	
fersen	Noun	1 month ago	
knie	Noun	1 month ago	
bauch	Noun	1 month ago	
daumen	Noun	1 month ago	
lippe	Noun	1 month ago	
gehirnen	Noun	1 month ago	
lunge	Noun	1 month ago	
kinn	Noun	1 month ago	
danke	Interjection	1 month ago	
tschüss	Interjection	1 month ago	
hallo	Interjection	1 month ago	
erneut	Adjective	1 month ago	
leichter	Adjective	1 month ago	
wöchentlich	Adjective	1 month ago	
hilfreich	Adjective	1 month ago	
weil	Conjunction	1 month ago	
bevor	Conjunction	1 month ago	
dadurch	Adverb	1 month ago	
monatlich	Adjective	1 month ago	
heutigen	Adjective	1 month ago	
gemeinsame	Adjective	1 month ago	
ehemaligen	Adjective	1 month ago	
eigenen	Adjective	1 month ago	
passenden	Adjective	1 month ago	
höheren	Adjective	1 month ago	
trocken	Adjective	1 month ago	
raus	Adverb	1 month ago	
inzwischen	Adverb	1 month ago	
erhöhen	Verb	1 month ago	
erwerben	Verb	1 month ago	
meinen	Pronoun	1 month ago	
brennen	Verb	1 month ago	
trete	Verb	1 month ago	
wirst	Verb	1 month ago	
werde	Verb	1 month ago	
werden	Verb	1 month ago	
tritt	Verb	1 month ago	
stimmt	Verb	1 month ago	
stimme	Verb	1 month ago	
müde	Adjective	1 month ago	
entwickelt	Verb	1 month ago	
vermeiden	Verb	1 month ago	
berechnen	Verb	1 month ago	
erwartest	Verb	1 month ago	
erwirbt	Verb	1 month ago	
erhöhst	Verb	1 month ago	
ermöglichen	Verb	1 month ago	
erscheinen	Verb	1 month ago	
ermitteln	Verb	1 month ago	
erhalten	Verb	1 month ago	
erreicht	Verb	1 month ago	
tut	Verb	1 month ago	
verdient	Verb	1 month ago	
unterstütze	Verb	1 month ago	
wenden	Verb	1 month ago	
tun	Verb	1 month ago	
achten	Verb	1 month ago	
wechseln	Verb	1 month ago	
verdienen	Verb	1 month ago	
ob	Conjunction	1 month ago	
definieren	Verb	1 month ago	
zitieren	Verb	1 month ago	
markiert	Verb	1 month ago	
präsentieren	Verb	1 month ago	
präsentiert	Verb	1 month ago	
markieren	Verb	1 month ago	
reden	Verb	1 month ago	
bitte	Verb	1 month ago	
rede	Verb	1 month ago	
meldet	Verb	1 month ago	
redest	Verb	1 month ago	
nennen	Verb	1 month ago	
springt	Verb	1 month ago	
wird	Verb	1 month ago	
brenne	Verb	1 month ago	
treten	Verb	1 month ago	
stimmen	Verb	1 month ago	
teilen	Verb	1 month ago	
nutzen	Verb	1 month ago	
teile	Verb	1 month ago	
fördern	Verb	1 month ago	
vergessen	Verb	1 month ago	
vergleichen	Verb	1 month ago	
verändern	Verb	1 month ago	
entwickeln	Verb	1 month ago	
vergesse	Verb	1 month ago	
verhindern	Verb	1 month ago	
betrifft	Verb	1 month ago	
beantwortet	Verb	1 month ago	
beantworten	Verb	1 month ago	
berechnet	Verb	1 month ago	
betreffen	Verb	1 month ago	
berichten	Verb	1 month ago	
erhält	Verb	1 month ago	
erleben	Verb	1 month ago	
erreichen	Verb	1 month ago	
erscheint	Verb	1 month ago	
erwarten	Verb	1 month ago	
ermittelt	Verb	1 month ago	
tue	Verb	1 month ago	
unterstützen	Verb	1 month ago	
verdiene	Verb	1 month ago	
dienen	Verb	1 month ago	
überprüfen	Verb	1 month ago	
bewerten	Verb	1 month ago	
achte	Verb	1 month ago	
präsentiere	Verb	1 month ago	
definiert	Verb	1 month ago	
kontaktieren	Verb	1 month ago	
definierst	Verb	1 month ago	
basiert	Verb	1 month ago	
basieren	Verb	1 month ago	
melden	Verb	1 month ago	
sichern	Verb	1 month ago	
bitten	Verb	1 month ago	
redet	Verb	1 month ago	
springe	Verb	1 month ago	
springen	Verb	1 month ago	
merken	Verb	1 month ago	
harmlos	Adjective	1 month ago	
gefährlich	Adjective	1 month ago	
verrückt	Adjective	1 month ago	
kühe	Noun	1 month ago	
mäuse	Noun	1 month ago	
größer	Adjective	1 month ago	
völlig	Adjective	1 month ago	
schlau	Adjective	1 month ago	
dumm	Adjective	1 month ago	
mädchen	Noun	1 month ago	
schwein	Noun	1 month ago	
schaf	Noun	1 month ago	
schlange	Noun	1 month ago	
sticht	Verb	1 month ago	
stechen	Verb	1 month ago	
wespe	Noun	1 month ago	
tiger	Noun	1 month ago	
hörner	Noun	1 month ago	
wale	Noun	1 month ago	
zebra	Noun	1 month ago	
reitet	Verb	1 month ago	
hamster	Noun	1 month ago	
giraffe	Noun	1 month ago	
reitest	Verb	1 month ago	
neunzig	Numeral	1 month ago	
pinguine	Noun	1 month ago	
säugetier	Noun	1 month ago	
kamele	Noun	1 month ago	
kamel	Noun	1 month ago	
gänse	Noun	1 month ago	
schmetterlinge	Noun	1 month ago	
beißen	Verb	1 month ago	
fuchs	Noun	1 month ago	
eule	Noun	1 month ago	
beiße	Verb	1 month ago	
eichhörnchen	Noun	1 month ago	
schafe	Noun	1 month ago	
gans	Noun	1 month ago	
hans	Proper noun	1 month ago	
normal	Adjective	1 month ago	
relativ	Adjective	1 month ago	
abhängig	Adjective	1 month ago	
öffentlichen	Adjective	1 month ago	
überhaupt	Adverb	1 month ago	
falsch	Adjective	1 month ago	
versuch	Noun	1 month ago	
sichtbar	Adjective	1 month ago	
gelegenheit	Noun	1 month ago	
super	Adjective	1 month ago	
sinnvoll	Adjective	1 month ago	
daher	Adverb	1 month ago	
jedoch	Adverb	1 month ago	
kaum	Adverb	1 month ago	
zuerst	Adverb	1 month ago	
engagement	Noun	1 month ago	
empfehlung	Noun	1 month ago	
hinweise	Noun	1 month ago	
qualität	Noun	1 month ago	
zusammenarbeit	Noun	1 month ago	
maße	Noun	1 month ago	
sicherheit	Noun	1 month ago	
ergebnisse	Noun	1 month ago	
hilfe	Noun	1 month ago	
entwicklung	Noun	1 month ago	
kompetenz	Noun	1 month ago	
empfehlungen	Noun	1 month ago	
auswahl	Noun	1 month ago	
nutzen	Noun	1 month ago	
druck	Noun	1 month ago	
lage	Noun	1 month ago	
weise	Noun	1 month ago	
ziele	Noun	1 month ago	
änderung	Noun	1 month ago	
hinweis	Noun	1 month ago	
verhalten	Noun	1 month ago	
problem	Noun	1 month ago	
lösungen	Noun	1 month ago	
form	Noun	1 month ago	
sonst	Adverb	1 month ago	
gehen	Verb	1 month ago	
selbstverständlich	Adjective	1 month ago	
sowohl	Conjunction	1 month ago	
individuelle	Adjective	1 month ago	
ihnen	Pronoun	1 month ago	
dreißig	Numeral	1 month ago	
begriffe	Noun	1 month ago	
allgemein	Adjective	1 month ago	
eher	Adverb	1 month ago	
wort	Noun	1 month ago	
idee	Noun	1 month ago	
wörter	Noun	1 month ago	
sprachen	Noun	1 month ago	
detaillierte	Adjective	1 month ago	
begriff	Noun	1 month ago	
übersetzung	Noun	1 month ago	
unterhaltung	Noun	1 month ago	
zusammenfassung	Noun	1 month ago	
bedeutet	Verb	1 month ago	
satz	Noun	1 month ago	
kapitel	Noun	1 month ago	
verzeichnis	Noun	1 month ago	
zeichen	Noun	1 month ago	
erklärung	Noun	1 month ago	
meinung	Noun	1 month ago	
meinungen	Noun	1 month ago	
konzept	Noun	1 month ago	
titel	Noun	1 month ago	
zustimmung	Noun	1 month ago	
geschichte	Noun	1 month ago	
texte	Noun	1 month ago	
berichte	Noun	1 month ago	
text	Noun	1 month ago	
erzähle	Verb	1 month ago	
geschichten	Noun	1 month ago	
bericht	Noun	1 month ago	
ideen	Noun	1 month ago	
schrift	Noun	1 month ago	
bedeutung	Noun	1 month ago	
beschreibung	Noun	1 month ago	
bunt	Adjective	1 month ago	
braun	Adjective	1 month ago	
esse	Verb	1 month ago	
großartig	Adjective	1 month ago	
verschiedene	Adjective	1 month ago	
höchste	Adjective	1 month ago	
weiterer	Adjective	1 month ago	
genug	Adverb	1 month ago	
bietet	Verb	1 month ago	
gebote	Noun	1 month ago	
kollegen	Noun	1 month ago	
wert	Noun	1 month ago	
projekte	Noun	1 month ago	
bewerbung	Noun	1 month ago	
karriere	Noun	1 month ago	
job	Noun	1 month ago	
jobs	Noun	1 month ago	
grau	Adjective	1 month ago	
mannes	Noun	1 month ago	
handel	Noun	1 month ago	
gewinne	Noun	1 month ago	
gewinn	Noun	1 month ago	
verbraucher	Noun	1 month ago	
kauf	Noun	1 month ago	
käufe	Noun	1 month ago	
käufer	Noun	1 month ago	
miete	Noun	1 month ago	
dokumente	Noun	1 month ago	
beiträge	Noun	1 month ago	
wettbewerb	Noun	1 month ago	
projekt	Noun	1 month ago	
management	Noun	1 month ago	
bestellungen	Noun	1 month ago	
beratung	Noun	1 month ago	
gebot	Noun	1 month ago	
bieten	Verb	1 month ago	
aktien	Noun	1 month ago	
mieten	Verb	1 month ago	
mietest	Verb	1 month ago	
bestellung	Noun	1 month ago	
organisation	Noun	1 month ago	
fabrik	Noun	1 month ago	
büro	Noun	1 month ago	
unternehmen	Noun	1 month ago	
inhaber	Noun	1 month ago	
mitgliedschaft	Noun	1 month ago	
fabriken	Noun	1 month ago	
dreizehn	Numeral	1 month ago	
zusätzliche	Adjective	1 month ago	
linken	Adjective	1 month ago	
briefkasten	Noun	1 month ago	
veröffentlichen	Verb	1 month ago	
kontakte	Noun	1 month ago	
briefe	Noun	1 month ago	
mitteilung	Noun	2 months ago	
radios	Noun	2 months ago	
mitteilungen	Noun	2 months ago	
anmeldung	Noun	2 months ago	
lautsprecher	Noun	2 months ago	
sender	Noun	2 months ago	
themen	Noun	2 months ago	
begründung	Noun	2 months ago	
bestätigung	Noun	2 months ago	
meldungen	Noun	2 months ago	
verlag	Noun	2 months ago	
veröffentlicht	Verb	2 months ago	
sendest	Verb	2 months ago	
senden	Verb	2 months ago	
kontakt	Noun	2 months ago	
einladungen	Noun	2 months ago	
einladung	Noun	2 months ago	
brief	Noun	2 months ago	
adresse	Noun	2 months ago	
anrede	Noun	2 months ago	
notiz	Noun	2 months ago	
grüße	Noun	2 months ago	
hinten	Adverb	2 months ago	
fertig	Adjective	2 months ago	
wohl	Adverb	2 months ago	
frauen	Noun	2 months ago	
einschließlich	Preposition	2 months ago	
ums	Preposition	2 months ago	
jemand	Determiner	2 months ago	
während	Preposition	2 months ago	
vögel	Noun	2 months ago	
irgendwo	Adverb	2 months ago	
gegenüber	Preposition	2 months ago	
leider	Adverb	2 months ago	
entweder	Conjunction	2 months ago	
schwimmen	Verb	2 months ago	
durchaus	Adverb	2 months ago	
zwölf	Numeral	2 months ago	
auf wiedersehen		2 months ago	
es tut mir leid		2 months ago	
analyse	Noun	2 months ago	
wissenschaftlerin	Noun	2 months ago	
zumindest	Adverb	2 months ago	
strahlung	Noun	2 months ago	
kenntnis	Noun	2 months ago	
also	Adverb	2 months ago	
nachweis	Noun	2 months ago	
kunststoff	Noun	2 months ago	
atmosphäre	Noun	2 months ago	
analysen	Noun	2 months ago	
gas	Noun	2 months ago	
lehrbücher	Noun	2 months ago	
teste	Verb	2 months ago	
testen	Verb	2 months ago	
praktika	Noun	2 months ago	
methode	Noun	2 months ago	
methoden	Noun	2 months ago	
praktikum	Noun	2 months ago	
wissenschaftlerinnen	Noun	2 months ago	
elemente	Noun	2 months ago	
technik	Noun	2 months ago	
maschinen	Noun	2 months ago	
wissen	Noun	2 months ago	
statistiken	Noun	2 months ago	
studien	Noun	2 months ago	
temperatur	Noun	2 months ago	
misst	Verb	2 months ago	
messen	Verb	2 months ago	
energie	Noun	2 months ago	
motor	Noun	2 months ago	
motoren	Noun	2 months ago	
messe	Verb	2 months ago	
wissenschaft	Noun	2 months ago	
erfindungen	Noun	2 months ago	
theorie	Noun	2 months ago	
erfindung	Noun	2 months ago	
definitionen	Noun	2 months ago	
kenntnisse	Noun	2 months ago	
definition	Noun	2 months ago	
naja	Interjection	2 months ago	
ziemlich	Adverb	2 months ago	
verzeihung	Noun	2 months ago	
esst	Verb	2 months ago	
trinkst	Verb	2 months ago	
es gibt		2 months ago	
wohin	Adverb	2 months ago	
elf	Numeral	2 months ago	
fünfzehn	Numeral	2 months ago	
dutzend	Noun	2 months ago	
neunzehn	Numeral	2 months ago	
ahnung	Noun	2 months ago	
nachdem	Conjunction	2 months ago	
automatisch	Adjective	2 months ago	
alte	Adjective	2 months ago	
weniger	Determiner	2 months ago	
keinerlei	Determiner	2 months ago	
desto	Conjunction	2 months ago	
häufig	Adjective	2 months ago	
damals	Adverb	2 months ago	
sechzig	Numeral	2 months ago	
viertel	Verb	2 months ago	
weder	Conjunction	2 months ago	
innenstädte	Noun	2 months ago	
bereiche	Noun	2 months ago	
plastik	Noun	2 months ago	
schneller	Adjective	2 months ago	
teurer	Adjective	2 months ago	
zweiten	Adjective	2 months ago	
sauer	Adjective	2 months ago	
kurse	Noun	2 months ago	
seminare	Noun	2 months ago	
stifte	Noun	2 months ago	
noten	Noun	2 months ago	
übrigen	Adjective	2 months ago	
traurig	Adjective	2 months ago	
erziehung	Noun	2 months ago	
prüfungen	Noun	2 months ago	
überlege	Verb	2 months ago	
überlegst	Verb	2 months ago	
fachbereich	Noun	2 months ago	
uni	Noun	2 months ago	
weiterbildung	Noun	2 months ago	
prüfung	Noun	2 months ago	
kindergarten	Noun	2 months ago	
gymnasium	Noun	2 months ago	
institute	Noun	2 months ago	
lehren	Verb	2 months ago	
hochschule	Noun	2 months ago	
institut	Noun	2 months ago	
unterricht	Noun	2 months ago	
akademie	Noun	2 months ago	
ausbildung	Noun	2 months ago	
hochschulen	Noun	2 months ago	
training	Noun	2 months ago	
klassen	Noun	2 months ago	
tests	Noun	2 months ago	
klasse	Noun	2 months ago	
test	Noun	2 months ago	
kurs	Noun	2 months ago	
seminar	Noun	2 months ago	
forschung	Noun	2 months ago	
studium	Noun	2 months ago	
unabhängig	Adjective	2 months ago	
note	Noun	2 months ago	
übungen	Noun	2 months ago	
stift	Noun	2 months ago	
übung	Noun	2 months ago	
stiften	Noun	2 months ago	
leser	Noun	2 months ago	
bildung	Noun	2 months ago	
universität	Noun	2 months ago	
siebzig	Numeral	2 months ago	
netze	Noun	2 months ago	
genauso	Adverb	2 months ago	
herunter	Adverb	2 months ago	
sozialen	Adjective	2 months ago	
achtundzwanzig	Numeral	2 months ago	
bis später		2 months ago	
stolz	Adjective	2 months ago	
total	Adjective	2 months ago	
langweilig	Adjective	2 months ago	
unheimlich	Adjective	2 months ago	
witzig	Adjective	2 months ago	
erlauben	Verb	2 months ago	
tasten	Noun	2 months ago	
lade	Verb	2 months ago	
bild	Noun	2 months ago	
bilder	Noun	2 months ago	
lösche	Verb	2 months ago	
programm	Noun	2 months ago	
löscht	Verb	2 months ago	
programme	Noun	2 months ago	
löschst	Verb	2 months ago	
drucken	Verb	2 months ago	
profile	Noun	2 months ago	
passwörter	Noun	2 months ago	
profil	Noun	2 months ago	
aktualisieren	Verb	2 months ago	
aktualisiert	Verb	2 months ago	
drucke	Verb	2 months ago	
aktualisiere	Verb	2 months ago	
taste	Noun	2 months ago	
druckst	Verb	2 months ago	
kommentar	Noun	2 months ago	
kommentare	Noun	2 months ago	
schickst	Verb	2 months ago	
schickt	Verb	2 months ago	
anhänge	Noun	2 months ago	
schicken	Verb	2 months ago	
anhang	Noun	2 months ago	
schicke	Verb	2 months ago	
läd	Verb	2 months ago	
netz	Noun	2 months ago	
laden	Verb	2 months ago	
seiten	Noun	2 months ago	
internet	Noun	2 months ago	
lädt	Verb	2 months ago	
fotos	Noun	2 months ago	
foto	Noun	2 months ago	
seite	Noun	2 months ago	
kühl	Adjective	2 months ago	
achtzehn	Numeral	2 months ago	
seit	Preposition	2 months ago	
bis bald		2 months ago	
schmutzig	Adjective	3 months ago	
trotzdem	Adverb	3 months ago	
zeitschrift	Noun	3 months ago	
herzlich	Adjective	3 months ago	
reden	Noun	3 months ago	
medien	Noun	3 months ago	
langsamer	Adjective	3 months ago	
wichtiger	Adjective	3 months ago	
starte	Verb	3 months ago	
rede	Noun	3 months ago	
sendung	Noun	3 months ago	
diskussionen	Noun	3 months ago	
medium	Noun	3 months ago	
fernseher	Noun	3 months ago	
sendungen	Noun	3 months ago	
fernsehen	Noun	3 months ago	
diskussion	Noun	3 months ago	
artikeln	Noun	3 months ago	
artikel	Noun	3 months ago	
interviews	Noun	3 months ago	
zeitschriften	Noun	3 months ago	
nachrichten	Noun	3 months ago	
presse	Noun	3 months ago	
interview	Noun	3 months ago	
nachricht	Noun	3 months ago	
festplatte	Noun	3 months ago	
festplatten	Noun	3 months ago	
information	Noun	3 months ago	
monitor	Noun	3 months ago	
starten	Verb	3 months ago	
tastaturen	Noun	3 months ago	
startet	Verb	3 months ago	
tastatur	Noun	3 months ago	
monitore	Noun	3 months ago	
computer	Noun	3 months ago	
handys	Noun	3 months ago	
telefon	Noun	3 months ago	
kommunikation	Noun	3 months ago	
telefone	Noun	3 months ago	
gespräch	Noun	3 months ago	
gespräche	Noun	3 months ago	
rufen	Verb	3 months ago	
handy	Noun	3 months ago	
plan	Noun	3 months ago	
privaten	Adjective	3 months ago	
deutschen	Adjective	3 months ago	
zweite	Adjective	3 months ago	
stellen	Noun	3 months ago	
kataloge	Noun	3 months ago	
pläne	Noun	3 months ago	
irgendwann	Adverb	3 months ago	
irgendwer	Determiner	3 months ago	
irgendwas	Determiner	3 months ago	
irgendwie	Adverb	3 months ago	
pakete	Noun	3 months ago	
boden	Noun	3 months ago	
böden	Noun	3 months ago	
paket	Noun	3 months ago	
geschenk	Noun	3 months ago	
zubehör	Noun	3 months ago	
stücke	Noun	3 months ago	
stück	Noun	3 months ago	
geschenke	Noun	3 months ago	
scheren	Noun	3 months ago	
sache	Noun	3 months ago	
produkt	Noun	3 months ago	
katalog	Noun	3 months ago	
schere	Noun	3 months ago	
produkte	Noun	3 months ago	
stelle	Noun	3 months ago	
sachen	Noun	3 months ago	
produkten	Noun	3 months ago	
sauber	Adjective	3 months ago	
nass	Adjective	3 months ago	
sechzehn	Numeral	3 months ago	
gemeinsam	Adjective	3 months ago	
meistens	Adverb	3 months ago	
wolke	Noun	3 months ago	
länger	Adjective	3 months ago	
wolken	Noun	3 months ago	
regenbogen	Noun	3 months ago	
blitze	Noun	3 months ago	
regenschirme	Noun	3 months ago	
regenschirm	Noun	3 months ago	
blitz	Noun	3 months ago	
donner	Noun	3 months ago	
sturms	Noun	3 months ago	
sturm	Noun	3 months ago	
regen	Noun	3 months ago	
wetter	Noun	3 months ago	
grad	Noun	3 months ago	
krank	Adjective	3 months ago	
schöner	Adjective	3 months ago	
unmöglich	Adjective	3 months ago	
vorher	Adverb	3 months ago	
ganzen	Adjective	3 months ago	
trinkt	Verb	3 months ago	
politischen	Adjective	3 months ago	
schönen	Adjective	3 months ago	
persönliche	Adjective	3 months ago	
freien	Adjective	3 months ago	
aktive	Adjective	3 months ago	
gelber	Adjective	3 months ago	
letzten	Adjective	3 months ago	
außen	Adverb	3 months ago	
hundert	Numeral	3 months ago	
zweiundvierzig	Numeral	3 months ago	
tausend	Numeral	3 months ago	
hundertdreiundzwanzig	Numeral	3 months ago	
ließen	Verb	3 months ago	
blieben	Verb	3 months ago	
verloren	Verb	3 months ago	
schrieben	Verb	3 months ago	
schlossen	Verb	3 months ago	
nahmen	Verb	3 months ago	
gaben	Verb	3 months ago	
dachtet	Verb	3 months ago	
sprachen	Verb	3 months ago	
lasen	Verb	3 months ago	
lagen	Verb	3 months ago	
wart	Verb	3 months ago	
begannst	Verb	3 months ago	
begannt	Verb	3 months ago	
saht	Verb	3 months ago	
zuständigen	Adjective	3 months ago	
offenen	Adjective	3 months ago	
zeigten	Verb	3 months ago	
hatte	Verb	3 months ago	
wurde	Verb	3 months ago	
zeigte	Verb	3 months ago	
hatten	Verb	3 months ago	
wurden	Verb	3 months ago	
stand	Verb	3 months ago	
konnte	Verb	3 months ago	
mussten	Verb	3 months ago	
musste	Verb	3 months ago	
sagte	Verb	3 months ago	
führte	Verb	3 months ago	
sagten	Verb	3 months ago	
machte	Verb	3 months ago	
spazierte	Verb	3 months ago	
spazierten	Verb	3 months ago	
arbeiteten	Verb	3 months ago	
arbeitete	Verb	3 months ago	
sagtest	Verb	3 months ago	
stellte	Verb	3 months ago	
schlief	Verb	3 months ago	
schliefen	Verb	3 months ago	
erhielten	Verb	3 months ago	
ließ	Verb	3 months ago	
fuhren	Verb	3 months ago	
schrieb	Verb	3 months ago	
blieb	Verb	3 months ago	
schloss	Verb	3 months ago	
erhielt	Verb	3 months ago	
verlor	Verb	3 months ago	
fanden	Verb	3 months ago	
dachte	Verb	3 months ago	
nahm	Verb	3 months ago	
lag	Verb	3 months ago	
gab	Verb	3 months ago	
dachtest	Verb	3 months ago	
sprach	Verb	3 months ago	
fand	Verb	3 months ago	
dachten	Verb	3 months ago	
las	Verb	3 months ago	
ging	Verb	3 months ago	
gingen	Verb	3 months ago	
kam	Verb	3 months ago	
schwamm	Verb	3 months ago	
sahen	Verb	3 months ago	
aß	Verb	3 months ago	
warst	Verb	3 months ago	
begann	Verb	3 months ago	
kamen	Verb	3 months ago	
waren	Verb	3 months ago	
aßt	Verb	3 months ago	
trankst	Verb	3 months ago	
sah	Verb	3 months ago	
schwammen	Verb	3 months ago	
trank	Verb	3 months ago	
aßen	Verb	3 months ago	
denn	Adverb	3 months ago	
eigentlich	Adverb	3 months ago	
ansonsten	Adverb	3 months ago	
übrigens	Adverb	3 months ago	
allerdings	Adverb	3 months ago	
wenigstens	Adverb	3 months ago	
drin	Adverb	3 months ago	
zugleich	Adverb	3 months ago	
betreiber	Noun	3 months ago	
spezialitäten	Noun	3 months ago	
vierzehn	Numeral	3 months ago	
schweizer franken		3 months ago	
meist	Adverb	3 months ago	
zweiundachtzig	Numeral	3 months ago	
zwanzig	Numeral	3 months ago	
einundzwanzig	Numeral	3 months ago	
dreiundzwanzig	Numeral	3 months ago	
vierundzwanzig	Numeral	3 months ago	
siebzehn	Numeral	3 months ago	
zweiunddreißig	Numeral	3 months ago	
ihres	Pronoun	3 months ago	
seines	Pronoun	3 months ago	
externe	Adjective	3 months ago	
starken	Adjective	3 months ago	
öffentliches	Adjective	3 months ago	
soziales	Adjective	3 months ago	
schenke	Verb	3 months ago	
schenkst	Verb	3 months ago	
schenkt	Verb	3 months ago	
zusätzlichen	Adjective	3 months ago	
gleichen	Adjective	3 months ago	
jungen	Adjective	3 months ago	
nächste	Adjective	3 months ago	
einfachen	Adjective	3 months ago	
größte	Adjective	3 months ago	
größten	Adjective	3 months ago	
internationalen	Adjective	3 months ago	
aktuelle	Adjective	3 months ago	
neuen	Adjective	3 months ago	
ehemalige	Adjective	3 months ago	
alten	Adjective	3 months ago	
neuesten	Adjective	3 months ago	
einfache	Adjective	3 months ago	
günstige	Adjective	3 months ago	
zuletzt	Adverb	3 months ago	
scharf	Adjective	3 months ago	
verfügbaren	Adjective	3 months ago	
englische	Adjective	3 months ago	
heraus	Adverb	4 months ago	
herein	Adverb	4 months ago	
unterwegs	Adverb	4 months ago	
deines	Pronoun	4 months ago	
deiner	Pronoun	4 months ago	
vierzig	Numeral	4 months ago	
achtzig	Numeral	4 months ago	
fünfzig	Numeral	4 months ago	
weit	Adjective	4 months ago	
notwendigen	Adjective	4 months ago	
westen	Noun	4 months ago	
richtung	Noun	4 months ago	
süden	Noun	4 months ago	
osten	Noun	4 months ago	
norden	Noun	4 months ago	
bieg	Verb	4 months ago	
biegt	Verb	4 months ago	
schenken	Verb	4 months ago	
weitere	Adjective	4 months ago	
einzige	Adjective	4 months ago	
wichtige	Adjective	4 months ago	
modernen	Adjective	4 months ago	
technischen	Adjective	4 months ago	
kostenlose	Adjective	4 months ago	
private	Adjective	4 months ago	
wichtigsten	Adjective	4 months ago	
zufälliger	Adjective	4 months ago	
normalen	Adjective	4 months ago	
nächster	Adjective	4 months ago	
jugendliche	Adjective	4 months ago	
tapfer	Adjective	4 months ago	
experte	Noun	4 months ago	
rechtsanwälte	Noun	4 months ago	
spezialität	Noun	4 months ago	
rechtsanwalt	Noun	4 months ago	
richter	Noun	4 months ago	
experten	Noun	4 months ago	
schneider	Noun	4 months ago	
werkstatt	Noun	4 months ago	
handwerk	Noun	4 months ago	
hersteller	Noun	4 months ago	
verfasser	Noun	4 months ago	
teilnehmern	Noun	4 months ago	
empfänger	Noun	4 months ago	
personal	Noun	4 months ago	
entwickler	Noun	4 months ago	
teilnehmer	Noun	4 months ago	
geschehen	Verb	4 months ago	
eis	Noun	4 months ago	
durst	Noun	4 months ago	
fit	Adjective	4 months ago	
plötzlich	Adjective	4 months ago	
ihrer	Pronoun	4 months ago	
hauses	Noun	4 months ago	
ströme	Noun	4 months ago	
wüsten	Noun	4 months ago	
flüsse	Noun	4 months ago	
bäche	Noun	4 months ago	
wälder	Noun	4 months ago	
rhein	Proper noun	4 months ago	
wiesen	Noun	4 months ago	
gräser	Noun	4 months ago	
klima	Noun	4 months ago	
pflanze	Noun	4 months ago	
strom	Noun	4 months ago	
landwirtschaft	Noun	4 months ago	
wüste	Noun	4 months ago	
pflanzen	Noun	4 months ago	
all	Noun	4 months ago	
wald	Noun	4 months ago	
bach	Noun	4 months ago	
wiese	Noun	4 months ago	
gras	Noun	4 months ago	
tierwelt	Noun	4 months ago	
umwelt	Noun	4 months ago	
strände	Noun	4 months ago	
bernstein	Noun	4 months ago	
see	Noun	4 months ago	
welle	Noun	4 months ago	
welt	Noun	4 months ago	
strand	Noun	4 months ago	
wellen	Noun	4 months ago	
luft	Noun	4 months ago	
etwa	Adverb	4 months ago	
grund	Noun	4 months ago	
erweitere	Verb	4 months ago	
übernehme	Verb	4 months ago	
suchst	Verb	4 months ago	
individuell	Adjective	4 months ago	
bekannt	Adjective	4 months ago	
extrem	Adjective	5 months ago	
weich	Adjective	5 months ago	
hart	Adjective	5 months ago	
spätestens	Adverb	5 months ago	
frisch	Adjective	5 months ago	
orte	Noun	5 months ago	
bundesländer	Noun	5 months ago	
hauptstädte	Noun	5 months ago	
ferienhäuser	Noun	5 months ago	
hallen	Noun	5 months ago	
innenstadt	Noun	5 months ago	
meisten	Determiner	5 months ago	
größeren	Adjective	5 months ago	
mal	Noun	5 months ago	
zahlreiche	Adjective	5 months ago	
größeres	Adjective	5 months ago	
wenigen	Determiner	5 months ago	
wenige	Determiner	5 months ago	
fast	Adverb	5 months ago	
nachts	Adverb	5 months ago	
halb	Adjective	5 months ago	
fest	Adjective	5 months ago	
sekunden	Noun	5 months ago	
sekunde	Noun	5 months ago	
uhrzeit	Noun	5 months ago	
uhren	Noun	5 months ago	
dauer	Noun	5 months ago	
zeitpunkt	Noun	5 months ago	
dauern	Verb	5 months ago	
mitternacht	Noun	5 months ago	
zeit	Noun	5 months ago	
uhr	Noun	5 months ago	
augenblick	Noun	5 months ago	
stunden	Noun	5 months ago	
zeiten	Noun	5 months ago	
stunde	Noun	5 months ago	
minute	Noun	5 months ago	
minuten	Noun	5 months ago	
abende	Noun	5 months ago	
zeitraum	Noun	5 months ago	
nacht	Noun	5 months ago	
abend	Noun	5 months ago	
nächte	Noun	5 months ago	
morgen	Noun	5 months ago	
mittag	Noun	5 months ago	
termine	Noun	5 months ago	
moment	Noun	5 months ago	
momente	Noun	5 months ago	
termin	Noun	5 months ago	
lacht	Verb	5 months ago	
schulden	Noun	5 months ago	
liebling	Noun	5 months ago	
lache	Verb	5 months ago	
verständnis	Noun	5 months ago	
lachen	Verb	5 months ago	
glück	Noun	5 months ago	
hasst	Verb	5 months ago	
lieblings	Noun	5 months ago	
hassen	Verb	5 months ago	
lust	Noun	5 months ago	
lustig	Adjective	5 months ago	
ärger	Noun	5 months ago	
gedanken	Noun	5 months ago	
witz	Noun	5 months ago	
gedanke	Noun	5 months ago	
humor	Noun	5 months ago	
ruhe	Noun	5 months ago	
zahnarzt	Noun	5 months ago	
standorte	Noun	5 months ago	
ausland	Noun	5 months ago	
zentren	Noun	5 months ago	
eindruck	Noun	5 months ago	
angst	Noun	5 months ago	
spaß	Noun	5 months ago	
ernst	Noun	5 months ago	
liebt	Verb	5 months ago	
liebe	Verb	5 months ago	
liebst	Verb	5 months ago	
träumen	Verb	5 months ago	
träumst	Verb	5 months ago	
wunsch	Noun	5 months ago	
träumt	Verb	5 months ago	
wünsche	Noun	5 months ago	
liebe	Noun	5 months ago	
not	Noun	5 months ago	
träume	Noun	5 months ago	
freude	Noun	5 months ago	
traum	Noun	5 months ago	
träume	Verb	5 months ago	
gute nacht		5 months ago	
guten morgen		5 months ago	
spielzeug	Noun	5 months ago	
januar	Noun	5 months ago	
september	Noun	5 months ago	
weihnachten	Noun	5 months ago	
winter	Noun	5 months ago	
daten	Noun	5 months ago	
quartal	Noun	5 months ago	
quartale	Noun	5 months ago	
phasen	Noun	5 months ago	
schluss	Noun	5 months ago	
alter	Noun	5 months ago	
geburtstag	Noun	5 months ago	
jahrhundert	Noun	5 months ago	
geburtstage	Noun	5 months ago	
phase	Noun	5 months ago	
jahrhunderte	Noun	5 months ago	
endet	Verb	5 months ago	
saison	Noun	5 months ago	
februar	Noun	5 months ago	
letzte	Adjective	5 months ago	
jahreszeiten	Noun	5 months ago	
november	Noun	5 months ago	
datum	Noun	5 months ago	
kalender	Noun	5 months ago	
herbst	Noun	5 months ago	
juli	Noun	5 months ago	
jahr	Noun	5 months ago	
juni	Noun	5 months ago	
sommer	Noun	5 months ago	
august	Noun	5 months ago	
jahre	Noun	5 months ago	
jahren	Noun	5 months ago	
frühling	Noun	5 months ago	
märz	Noun	5 months ago	
monat	Noun	5 months ago	
monate	Noun	5 months ago	
mai	Noun	5 months ago	
monaten	Noun	5 months ago	
april	Noun	5 months ago	
spargel	Noun	5 months ago	
paar	Noun	5 months ago	
bevölkerung	Noun	5 months ago	
paare	Noun	5 months ago	
einwohner	Noun	5 months ago	
gemeinde	Noun	5 months ago	
verein	Noun	5 months ago	
verbindungen	Noun	5 months ago	
vereine	Noun	5 months ago	
gemeinden	Noun	5 months ago	
verbindung	Noun	5 months ago	
nutzer	Noun	5 months ago	
öffentlichkeit	Noun	5 months ago	
verhältnis	Noun	5 months ago	
schauen	Verb	6 months ago	
benutzen	Verb	6 months ago	
erweitern	Verb	6 months ago	
stehen	Verb	6 months ago	
warten	Verb	6 months ago	
nimmt	Verb	6 months ago	
arbeiten	Verb	6 months ago	
arbeitest	Verb	6 months ago	
schaut	Verb	6 months ago	
stehle	Verb	6 months ago	
schaue	Verb	6 months ago	
stehlen	Verb	6 months ago	
ersetze	Verb	6 months ago	
übernimmst	Verb	6 months ago	
trefft	Verb	6 months ago	
liege	Verb	6 months ago	
stellst	Verb	6 months ago	
nimmst	Verb	6 months ago	
änderst	Verb	6 months ago	
hofft	Verb	6 months ago	
hemden	Noun	6 months ago	
sammelt	Verb	6 months ago	
steigt	Verb	6 months ago	
stehlt	Verb	6 months ago	
prüfen	Verb	6 months ago	
prüft	Verb	6 months ago	
meine	Verb	6 months ago	
fehlt	Verb	6 months ago	
meinst	Verb	6 months ago	
stiehlt	Verb	6 months ago	
steigen	Verb	6 months ago	
sammeln	Verb	6 months ago	
sammle	Verb	6 months ago	
meint	Verb	6 months ago	
fehlen	Verb	6 months ago	
akzeptiere	Verb	6 months ago	
abonniert	Verb	6 months ago	
akzeptiert	Verb	6 months ago	
passieren	Verb	6 months ago	
passiert	Verb	6 months ago	
spaziert	Verb	6 months ago	
abonniere	Verb	6 months ago	
spazieren	Verb	6 months ago	
abonnieren	Verb	6 months ago	
akzeptieren	Verb	6 months ago	
bestellt	Verb	6 months ago	
schließen	Verb	6 months ago	
erkennt	Verb	6 months ago	
verpasst	Verb	6 months ago	
erlaubt	Verb	6 months ago	
erkennst	Verb	6 months ago	
übernimmt	Verb	6 months ago	
bestellen	Verb	6 months ago	
benutzt	Verb	6 months ago	
erkennen	Verb	6 months ago	
ersetzen	Verb	6 months ago	
verpassen	Verb	6 months ago	
ersetzt	Verb	6 months ago	
liegst	Verb	6 months ago	
stellt	Verb	6 months ago	
glauben	Verb	6 months ago	
warte	Verb	6 months ago	
wartest	Verb	6 months ago	
scheint	Verb	6 months ago	
wartet	Verb	6 months ago	
liegt	Verb	6 months ago	
glaube	Verb	6 months ago	
glaubt	Verb	6 months ago	
stehst	Verb	6 months ago	
treffen	Verb	6 months ago	
steht	Verb	6 months ago	
stellen	Verb	6 months ago	
trifft	Verb	6 months ago	
bleibt	Verb	6 months ago	
kannst	Verb	6 months ago	
nehmen	Verb	6 months ago	
ändert	Verb	6 months ago	
gefallen	Verb	6 months ago	
kann	Verb	6 months ago	
könnt	Verb	6 months ago	
können	Verb	6 months ago	
wissen	Verb	6 months ago	
arbeite	Verb	6 months ago	
hoffe	Verb	6 months ago	
halten	Verb	6 months ago	
hoffen	Verb	6 months ago	
hält	Verb	6 months ago	
wisst	Verb	6 months ago	
singen	Verb	6 months ago	
weißt	Verb	6 months ago	
weiß	Verb	6 months ago	
arbeitet	Verb	6 months ago	
singe	Verb	6 months ago	
singt	Verb	6 months ago	
singst	Verb	6 months ago	
rollstühle	Noun	6 months ago	
diät	Noun	6 months ago	
therapie	Noun	6 months ago	
ernährung	Noun	6 months ago	
alkohol	Noun	6 months ago	
klinik	Noun	6 months ago	
unfall	Noun	6 months ago	
notfälle	Noun	6 months ago	
schlechte	Adjective	6 months ago	
opfern	Noun	6 months ago	
zahnärztin	Noun	6 months ago	
unfälle	Noun	6 months ago	
notfall	Noun	6 months ago	
opfer	Noun	6 months ago	
krankenwagen	Noun	6 months ago	
krankenhäuser	Noun	6 months ago	
krankenversicherung	Noun	6 months ago	
medizin	Noun	6 months ago	
krankenhaus	Noun	6 months ago	
untersuchungen	Noun	6 months ago	
krankheiten	Noun	6 months ago	
gesundheit	Noun	6 months ago	
formulare	Noun	6 months ago	
krankheit	Noun	6 months ago	
praxis	Noun	6 months ago	
formular	Noun	6 months ago	
untersuchung	Noun	6 months ago	
blute	Verb	6 months ago	
patient	Noun	6 months ago	
bluten	Verb	6 months ago	
patienten	Noun	6 months ago	
medikamente	Noun	6 months ago	
pflaster	Noun	6 months ago	
blutet	Verb	6 months ago	
rollstuhl	Noun	6 months ago	
blutest	Verb	6 months ago	
medikament	Noun	6 months ago	
plätze	Noun	6 months ago	
flächen	Noun	6 months ago	
kneipen	Noun	6 months ago	
gründe	Noun	6 months ago	
bezirke	Noun	6 months ago	
nebenan	Adverb	6 months ago	
seltsam	Adjective	6 months ago	
kleines	Adjective	6 months ago	
inseln	Noun	6 months ago	
hauptstadt	Noun	6 months ago	
europa	Proper noun	6 months ago	
innere	Noun	6 months ago	
heimat	Noun	6 months ago	
ferienhaus	Noun	6 months ago	
insel	Noun	6 months ago	
umgebung	Noun	6 months ago	
fläche	Noun	6 months ago	
grundstück	Noun	6 months ago	
höfe	Noun	6 months ago	
zentrum	Noun	6 months ago	
zentrale	Noun	6 months ago	
halle	Noun	6 months ago	
hof	Noun	6 months ago	
region	Noun	6 months ago	
bezirk	Noun	6 months ago	
regionen	Noun	6 months ago	
bundesland	Noun	6 months ago	
standort	Noun	6 months ago	
flughafen	Noun	6 months ago	
unterkunft	Noun	6 months ago	
wohnst	Verb	6 months ago	
bereich	Noun	6 months ago	
bereichen	Noun	6 months ago	
ort	Noun	6 months ago	
platz	Noun	6 months ago	
kneipe	Noun	6 months ago	
pension	Noun	6 months ago	
drüben	Adverb	6 months ago	
unten	Adverb	6 months ago	
innen	Adverb	6 months ago	
drinnen	Adverb	6 months ago	
original	Adjective	6 months ago	
guter	Adjective	6 months ago	
weißen	Adjective	7 months ago	
dran	Adverb	7 months ago	
wochenenden	Noun	7 months ago	
anfang	Noun	7 months ago	
vergangenheit	Noun	7 months ago	
alltag	Noun	7 months ago	
ende	Noun	7 months ago	
wochenende	Noun	7 months ago	
samstag	Noun	7 months ago	
sonntage	Noun	7 months ago	
woche	Noun	7 months ago	
wochen	Noun	7 months ago	
sonntag	Noun	7 months ago	
samstage	Noun	7 months ago	
mittwoch	Noun	7 months ago	
tage	Noun	7 months ago	
montag	Noun	7 months ago	
dienstag	Noun	7 months ago	
donnerstag	Noun	7 months ago	
tag	Noun	7 months ago	
tagen	Noun	7 months ago	
freitag	Noun	7 months ago	
kartons	Noun	7 months ago	
rucksack	Noun	7 months ago	
tor	Noun	7 months ago	
kühlschränke	Noun	7 months ago	
duschen	Verb	7 months ago	
bad	Noun	7 months ago	
rucksäcke	Noun	7 months ago	
schüsseln	Noun	7 months ago	
räume	Noun	7 months ago	
zahnbürste	Noun	7 months ago	
duschen	Noun	7 months ago	
handtücher	Noun	7 months ago	
handtuch	Noun	7 months ago	
duschgel	Noun	7 months ago	
dusche	Noun	7 months ago	
seife	Noun	7 months ago	
duscht	Verb	7 months ago	
flaschen	Noun	7 months ago	
duschst	Verb	7 months ago	
spiegel	Noun	7 months ago	
rasierer	Noun	7 months ago	
flasche	Noun	7 months ago	
kühlschrank	Noun	7 months ago	
schüssel	Noun	7 months ago	
karton	Noun	7 months ago	
toilette	Noun	7 months ago	
tasse	Noun	7 months ago	
tassen	Noun	7 months ago	
teller	Noun	7 months ago	
zahnpasta	Noun	7 months ago	
batterie	Noun	7 months ago	
leiter	Noun	7 months ago	
raum	Noun	7 months ago	
leitern	Noun	7 months ago	
gläser	Noun	7 months ago	
batterien	Noun	7 months ago	
glas	Noun	7 months ago	
umzug	Noun	7 months ago	
geräte	Noun	7 months ago	
haushalt	Noun	7 months ago	
schlaf	Noun	7 months ago	
reinigung	Noun	7 months ago	
gerät	Noun	7 months ago	
heizung	Noun	7 months ago	
haushaltsgeräte	Noun	7 months ago	
leise	Adjective	7 months ago	
gutem	Adjective	7 months ago	
beste	Adjective	7 months ago	
besten	Adjective	7 months ago	
bessere	Adjective	7 months ago	
besseren	Adjective	7 months ago	
gutes	Adjective	7 months ago	
guten	Adjective	7 months ago	
gute	Adjective	7 months ago	
geschäfte	Noun	7 months ago	
bäckereien	Noun	7 months ago	
gutschein	Noun	7 months ago	
großer	Adjective	7 months ago	
größere	Adjective	7 months ago	
schnelles	Adjective	7 months ago	
schnecke	Noun	7 months ago	
größen	Noun	7 months ago	
großes	Adjective	7 months ago	
große	Adjective	7 months ago	
größe	Noun	7 months ago	
kleinen	Adjective	7 months ago	
großen	Adjective	7 months ago	
sechste	Adjective	7 months ago	
siebte	Verb	7 months ago	
mathematik	Noun	7 months ago	
erster	Adjective	7 months ago	
erstes	Adjective	7 months ago	
erste	Adjective	7 months ago	
dritten	Adjective	7 months ago	
dritte	Adjective	7 months ago	
ersten	Adjective	7 months ago	
metalle	Noun	8 months ago	
metall	Noun	8 months ago	
silber	Noun	8 months ago	
gold	Noun	8 months ago	
stahl	Noun	8 months ago	
kupfer	Noun	8 months ago	
mauer	Noun	8 months ago	
pappe	Noun	8 months ago	
papiere	Noun	8 months ago	
leder	Noun	8 months ago	
papier	Noun	8 months ago	
baumwolle	Noun	8 months ago	
holz	Noun	8 months ago	
mauern	Noun	8 months ago	
wolle	Noun	8 months ago	
beton	Noun	8 months ago	
stein	Noun	8 months ago	
steine	Noun	8 months ago	
bücher	Noun	8 months ago	
fahrzeuge	Noun	8 months ago	
werkzeuge	Noun	8 months ago	
spielzeuge	Noun	8 months ago	
flugzeuge	Noun	8 months ago	
tief	Adjective	8 months ago	
außer	Preposition	8 months ago	
wegen	Preposition	8 months ago	
an	Preposition	8 months ago	
hinter	Preposition	8 months ago	
ab	Preposition	8 months ago	
neben	Preposition	8 months ago	
vor	Preposition	8 months ago	
unter	Preposition	8 months ago	
über	Preposition	8 months ago	
zwischen	Preposition	8 months ago	
legt	Verb	8 months ago	
lege	Verb	8 months ago	
legen	Verb	8 months ago	
in	Preposition	8 months ago	
auf	Preposition	8 months ago	
händler	Noun	8 months ago	
bäckerin	Noun	8 months ago	
lehrerin	Noun	8 months ago	
hälften	Noun	8 months ago	
schülerin	Noun	8 months ago	
architekten	Noun	8 months ago	
chefs	Noun	8 months ago	
chefinnen	Noun	8 months ago	
trainer	Noun	8 months ago	
arbeitgeberin	Noun	8 months ago	
arbeitgeber	Noun	8 months ago	
studentinnen	Noun	8 months ago	
professoren	Noun	8 months ago	
student	Noun	8 months ago	
köchinnen	Noun	8 months ago	
bäcker	Noun	8 months ago	
verkäufer	Noun	8 months ago	
feuerwehr	Noun	8 months ago	
architekt	Noun	8 months ago	
bedienung	Noun	8 months ago	
fahrer	Noun	8 months ago	
bauern	Noun	8 months ago	
bauer	Noun	8 months ago	
autor	Noun	8 months ago	
senior	Noun	8 months ago	
senioren	Noun	8 months ago	
chefin	Noun	8 months ago	
meister	Noun	8 months ago	
bürgermeister	Noun	8 months ago	
arbeitgeberinnen	Noun	8 months ago	
mitarbeiterinnen	Noun	8 months ago	
geschäftsführer	Noun	8 months ago	
arbeit	Noun	8 months ago	
mitarbeiterin	Noun	8 months ago	
arbeiten	Noun	8 months ago	
arbeitnehmer	Noun	8 months ago	
mitarbeiter	Noun	8 months ago	
professor	Noun	8 months ago	
schülerinnen	Noun	8 months ago	
lehrerinnen	Noun	8 months ago	
professorin	Noun	8 months ago	
lehrer	Noun	8 months ago	
studenten	Noun	8 months ago	
schüler	Noun	8 months ago	
studentin	Noun	8 months ago	
köche	Noun	8 months ago	
ärzte	Noun	8 months ago	
beruf	Noun	8 months ago	
ärztin	Noun	8 months ago	
berufe	Noun	8 months ago	
arzt	Noun	8 months ago	
koch	Noun	8 months ago	
handelt	Verb	8 months ago	
sei	Verb	8 months ago	
gehe	Verb	8 months ago	
geh	Verb	8 months ago	
handle	Verb	8 months ago	
lass	Verb	8 months ago	
ruf	Verb	8 months ago	
lasst	Verb	8 months ago	
nimm	Verb	8 months ago	
trink	Verb	8 months ago	
iss	Verb	8 months ago	
trinke	Verb	8 months ago	
lies	Verb	8 months ago	
nehmt	Verb	8 months ago	
gebt	Verb	8 months ago	
busse	Noun	8 months ago	
buntes	Adjective	8 months ago	
grauen	Adjective	8 months ago	
braune	Adjective	8 months ago	
grünes	Adjective	8 months ago	
grünen	Adjective	8 months ago	
weißes	Adjective	8 months ago	
weiße	Adjective	8 months ago	
rot	Noun	8 months ago	
rote	Adjective	8 months ago	
grüne	Adjective	8 months ago	
roter	Adjective	8 months ago	
rotes	Adjective	8 months ago	
blaue	Adjective	8 months ago	
blauen	Adjective	8 months ago	
roten	Adjective	8 months ago	
schwarze	Adjective	8 months ago	
schwarzes	Adjective	8 months ago	
farben	Noun	8 months ago	
farbe	Noun	8 months ago	
milliarden	Noun	8 months ago	
milliarde	Noun	8 months ago	
millionen	Noun	8 months ago	
million	Noun	8 months ago	
liter	Noun	8 months ago	
prozent	Noun	8 months ago	
prozente	Noun	8 months ago	
meter	Noun	8 months ago	
bucht	Verb	8 months ago	
tour	Noun	8 months ago	
strecke	Noun	8 months ago	
autos	Noun	8 months ago	
wandere	Verb	8 months ago	
urlaub	Noun	9 months ago	
zug	Noun	9 months ago	
buche	Verb	9 months ago	
fliegt	Verb	9 months ago	
touren	Noun	9 months ago	
abenteuer	Noun	9 months ago	
wandert	Verb	9 months ago	
motorrad	Noun	9 months ago	
sehenswürdigkeit	Noun	9 months ago	
flüge	Noun	9 months ago	
reiseführer	Noun	9 months ago	
reisen	Noun	9 months ago	
pass	Noun	9 months ago	
bus	Noun	9 months ago	
fahrrad	Noun	9 months ago	
verspätung	Noun	9 months ago	
fähre	Noun	9 months ago	
bushaltestelle	Noun	9 months ago	
schweden	Noun	9 months ago	
fliegst	Verb	9 months ago	
besuch	Noun	9 months ago	
fähren	Noun	9 months ago	
buchen	Verb	9 months ago	
wandern	Verb	9 months ago	
italien	Proper noun	9 months ago	
großbritannien	Proper noun	9 months ago	
boot	Noun	9 months ago	
bahn	Noun	9 months ago	
boote	Noun	9 months ago	
wanderst	Verb	9 months ago	
strecken	Noun	9 months ago	
motorräder	Noun	9 months ago	
fahrt	Noun	9 months ago	
mietwagen	Noun	9 months ago	
schweiz	Proper noun	9 months ago	
schweizer	Noun	9 months ago	
verkehr	Noun	9 months ago	
stadtplan	Noun	9 months ago	
flug	Noun	9 months ago	
taxi	Noun	9 months ago	
tourismus	Noun	9 months ago	
wege	Noun	9 months ago	
sehenswürdigkeiten	Noun	9 months ago	
spanien	Proper noun	9 months ago	
weg	Noun	9 months ago	
pässe	Noun	9 months ago	
afrika	Proper noun	9 months ago	
visa	Noun	9 months ago	
visum	Noun	9 months ago	
frankreich	Proper noun	9 months ago	
hamburg	Proper noun	9 months ago	
ferien	Noun	9 months ago	
zoll	Noun	9 months ago	
reise	Noun	9 months ago	
züge	Noun	9 months ago	
fahrräder	Noun	9 months ago	
österreich	Proper noun	9 months ago	
wien	Proper noun	9 months ago	
auto	Noun	9 months ago	
gabel	Noun	9 months ago	
nachtisch	Noun	9 months ago	
supermarkt	Noun	9 months ago	
supermärkte	Noun	9 months ago	
kundinnen	Noun	9 months ago	
läden	Noun	9 months ago	
apotheken	Noun	9 months ago	
sonderangebot	Noun	9 months ago	
gutscheine	Noun	9 months ago	
apotheke	Noun	9 months ago	
einkaufszentrum	Noun	9 months ago	
tüten	Noun	9 months ago	
verkaufe	Verb	9 months ago	
verkauft	Verb	9 months ago	
tüte	Noun	9 months ago	
einkaufswagen	Noun	9 months ago	
kasse	Noun	9 months ago	
verkaufen	Verb	9 months ago	
verkaufst	Verb	9 months ago	
laden	Noun	9 months ago	
geschäft	Noun	9 months ago	
marktplatz	Noun	9 months ago	
bäckerei	Noun	9 months ago	
hals	Noun	9 months ago	
rücken	Noun	9 months ago	
schultern	Noun	9 months ago	
hälse	Noun	9 months ago	
münder	Noun	9 months ago	
arme	Noun	9 months ago	
hände	Noun	9 months ago	
haar	Noun	9 months ago	
augen	Noun	9 months ago	
gesichter	Noun	9 months ago	
haut	Noun	9 months ago	
blut	Noun	9 months ago	
füße	Noun	9 months ago	
gesicht	Noun	9 months ago	
bein	Noun	9 months ago	
fuß	Noun	9 months ago	
beine	Noun	9 months ago	
mägen	Noun	9 months ago	
herz	Noun	9 months ago	
brust	Noun	9 months ago	
herzen	Noun	9 months ago	
magen	Noun	9 months ago	
brüste	Noun	9 months ago	
schulter	Noun	9 months ago	
zahn	Noun	9 months ago	
drücken	Verb	9 months ago	
mund	Noun	9 months ago	
drücke	Verb	9 months ago	
drückt	Verb	9 months ago	
finger	Noun	9 months ago	
hand	Noun	9 months ago	
kopf	Noun	9 months ago	
ohr	Noun	9 months ago	
nasen	Noun	9 months ago	
haare	Noun	9 months ago	
auge	Noun	9 months ago	
körper	Noun	9 months ago	
köpfe	Noun	9 months ago	
speisekarten	Noun	9 months ago	
zwilling	Noun	9 months ago	
urenkel	Noun	9 months ago	
halbschwestern	Noun	9 months ago	
hochzeiten	Noun	9 months ago	
halbbrüder	Noun	9 months ago	
halbbruder	Noun	9 months ago	
hochzeit	Noun	9 months ago	
partnerschaften	Noun	9 months ago	
partnerschaft	Noun	9 months ago	
halbschwester	Noun	9 months ago	
urgroßmutter	Noun	9 months ago	
cousinen	Noun	9 months ago	
zwillinge	Noun	9 months ago	
cousins	Noun	9 months ago	
cousine	Noun	9 months ago	
verwandten	Noun	9 months ago	
onkel	Noun	9 months ago	
nichten	Noun	9 months ago	
tanten	Noun	9 months ago	
neffen	Noun	9 months ago	
verwandte	Noun	9 months ago	
sonne	Noun	9 months ago	
deinem	Pronoun	9 months ago	
ihrem	Pronoun	9 months ago	
folgt	Verb	9 months ago	
diesem	Pronoun	9 months ago	
welchem	Determiner	9 months ago	
vielen	Determiner	9 months ago	
dieser	Pronoun	9 months ago	
beiden	Determiner	9 months ago	
folgst	Verb	9 months ago	
seinem	Pronoun	9 months ago	
unserem	Pronoun	9 months ago	
seinen	Pronoun	9 months ago	
unseren	Pronoun	9 months ago	
folgen	Verb	9 months ago	
seiner	Pronoun	9 months ago	
unserer	Pronoun	9 months ago	
folge	Verb	9 months ago	
gehören	Verb	9 months ago	
danken	Verb	9 months ago	
gehörst	Verb	9 months ago	
danke	Verb	9 months ago	
dankst	Verb	9 months ago	
helft	Verb	9 months ago	
helfe	Verb	9 months ago	
hilft	Verb	9 months ago	
dankt	Verb	9 months ago	
gehört	Verb	9 months ago	
hilfst	Verb	9 months ago	
helfen	Verb	9 months ago	
trinkgeld	Noun	9 months ago	
cents	Noun	9 months ago	
summen	Noun	9 months ago	
nummern	Noun	9 months ago	
telefonnummern	Noun	9 months ago	
kaufe	Verb	9 months ago	
gewinne	Verb	9 months ago	
gewinnt	Verb	9 months ago	
kaufst	Verb	9 months ago	
dollars	Noun	9 months ago	
überweise	Verb	9 months ago	
besitzen	Verb	9 months ago	
gewinnst	Verb	9 months ago	
überweist	Verb	9 months ago	
besitzt	Verb	9 months ago	
dollar	Noun	9 months ago	
euro	Noun	9 months ago	
kauft	Verb	9 months ago	
kaufen	Verb	9 months ago	
euros	Noun	9 months ago	
geld	Noun	9 months ago	
cent	Noun	9 months ago	
preise	Noun	9 months ago	
preis	Noun	9 months ago	
kostet	Verb	9 months ago	
schlösser	Noun	9 months ago	
brücken	Noun	9 months ago	
banken	Noun	9 months ago	
baust	Verb	9 months ago	
bänke	Noun	9 months ago	
bank	Noun	9 months ago	
sagen	Verb	9 months ago	
sagst	Verb	9 months ago	
sage	Verb	9 months ago	
sagt	Verb	9 months ago	
zeigst	Verb	9 months ago	
zeige	Verb	9 months ago	
zeigt	Verb	9 months ago	
zeigen	Verb	9 months ago	
gibst	Verb	9 months ago	
gebe	Verb	9 months ago	
geben	Verb	9 months ago	
gibt	Verb	9 months ago	
antworte	Verb	9 months ago	
antworten	Verb	9 months ago	
antwortet	Verb	9 months ago	
pilze	Noun	10 months ago	
frühstücke	Verb	10 months ago	
nüsse	Noun	10 months ago	
gabeln	Noun	10 months ago	
löffel	Noun	10 months ago	
kuchen	Noun	10 months ago	
abendessen	Noun	10 months ago	
zwiebeln	Noun	10 months ago	
knoblauch	Noun	10 months ago	
vorspeise	Noun	10 months ago	
senf	Noun	10 months ago	
hauptgericht	Noun	10 months ago	
bohnen	Noun	10 months ago	
kochen	Verb	10 months ago	
kocht	Verb	10 months ago	
koche	Verb	10 months ago	
kochst	Verb	10 months ago	
pilz	Noun	10 months ago	
hähnchen	Noun	10 months ago	
tomate	Noun	10 months ago	
mittagessen	Noun	10 months ago	
rezept	Noun	10 months ago	
butter	Noun	10 months ago	
marmelade	Noun	10 months ago	
honig	Noun	10 months ago	
frühstückt	Verb	10 months ago	
müsli	Noun	10 months ago	
frühstück	Noun	10 months ago	
nuss	Noun	10 months ago	
frühstücken	Verb	10 months ago	
frühstückst	Verb	10 months ago	
summe	Noun	10 months ago	
zählt	Verb	10 months ago	
hälfte	Noun	10 months ago	
zahl	Noun	10 months ago	
telefonnummer	Noun	10 months ago	
zahlen	Noun	10 months ago	
nummer	Noun	10 months ago	
entlang		10 months ago	
ihren	Pronoun	10 months ago	
ihre	Pronoun	10 months ago	
ecken	Noun	10 months ago	
straßen	Noun	10 months ago	
enkelinnen	Noun	10 months ago	
großmütter	Noun	10 months ago	
großväter	Noun	10 months ago	
beziehungen	Noun	10 months ago	
familien	Noun	10 months ago	
müttern	Noun	10 months ago	
vater	Noun	10 months ago	
mutter	Noun	10 months ago	
mütter	Noun	10 months ago	
omas	Noun	10 months ago	
opas	Noun	10 months ago	
oma	Noun	10 months ago	
opa	Noun	10 months ago	
großvater	Noun	10 months ago	
großmutter	Noun	10 months ago	
enkel	Noun	10 months ago	
enkelin	Noun	10 months ago	
beziehung	Noun	10 months ago	
familie	Noun	10 months ago	
partner	Noun	10 months ago	
geschwister	Noun	10 months ago	
tochter	Noun	10 months ago	
töchter	Noun	10 months ago	
väter	Noun	10 months ago	
söhne	Noun	10 months ago	
brüder	Noun	10 months ago	
schwestern	Noun	10 months ago	
bruder	Noun	10 months ago	
schwester	Noun	10 months ago	
sohn	Noun	10 months ago	
antwortest	Verb	10 months ago	
welche	Determiner	10 months ago	
wen	Pronoun	10 months ago	
wessen	Pronoun	10 months ago	
antworten	Noun	10 months ago	
wem	Pronoun	10 months ago	
wer	Pronoun	10 months ago	
antwort	Noun	10 months ago	
frage	Noun	10 months ago	
was	Pronoun	10 months ago	
fragen	Noun	10 months ago	
geschlechter	Noun	10 months ago	
gruppen	Noun	10 months ago	
dame	Noun	10 months ago	
personen	Noun	10 months ago	
freundinnen	Noun	10 months ago	
nachbarn	Noun	10 months ago	
feinde	Noun	10 months ago	
fan	Noun	10 months ago	
nachbar	Noun	10 months ago	
mitglied	Noun	10 months ago	
mitglieder	Noun	10 months ago	
anfänger	Noun	10 months ago	
fans	Noun	10 months ago	
besucher	Noun	10 months ago	
gruppe	Noun	10 months ago	
publikum	Noun	10 months ago	
gäste	Noun	10 months ago	
gast	Noun	10 months ago	
gegner	Noun	10 months ago	
geschlecht	Noun	10 months ago	
türke	Noun	10 months ago	
herr	Noun	10 months ago	
erwachsene	Noun	10 months ago	
herren	Noun	10 months ago	
damen	Noun	10 months ago	
bürger	Noun	10 months ago	
name	Noun	10 months ago	
person	Noun	10 months ago	
vornamen	Noun	10 months ago	
vorname	Noun	10 months ago	
freunde	Noun	10 months ago	
namen	Noun	10 months ago	
baby	Noun	10 months ago	
freundin	Noun	10 months ago	
freund	Noun	10 months ago	
babys	Noun	10 months ago	
sofas	Noun	10 months ago	
lampen	Noun	10 months ago	
lichter	Noun	10 months ago	
stühlen	Noun	10 months ago	
schränke	Noun	10 months ago	
stühle	Noun	10 months ago	
balkone	Noun	10 months ago	
decken	Noun	10 months ago	
lampe	Noun	10 months ago	
betten	Noun	10 months ago	
steckdose	Noun	10 months ago	
bett	Noun	10 months ago	
teppiche	Noun	10 months ago	
teppich	Noun	10 months ago	
steckdosen	Noun	10 months ago	
licht	Noun	10 months ago	
tische	Noun	10 months ago	
schrank	Noun	10 months ago	
tisch	Noun	10 months ago	
sofa	Noun	10 months ago	
wohnzimmer	Noun	10 months ago	
stuhl	Noun	10 months ago	
möbel	Noun	10 months ago	
küchen	Noun	10 months ago	
balkon	Noun	10 months ago	
wohnungen	Noun	10 months ago	
wohnung	Noun	10 months ago	
dach	Noun	10 months ago	
keller	Noun	10 months ago	
dächer	Noun	10 months ago	
schlüssel	Noun	10 months ago	
küche	Noun	10 months ago	
treppe	Noun	10 months ago	
türen	Noun	10 months ago	
zäune	Noun	10 months ago	
zaun	Noun	10 months ago	
treppen	Noun	10 months ago	
öffnet	Verb	10 months ago	
öffne	Verb	10 months ago	
tür	Noun	10 months ago	
decke	Noun	10 months ago	
wände	Noun	10 months ago	
fenster	Noun	10 months ago	
öffnen	Verb	10 months ago	
meines	Pronoun	10 months ago	
alle	Determiner	10 months ago	
anderen	Determiner	10 months ago	
jede	Determiner	10 months ago	
sein	Pronoun	10 months ago	
diesen	Pronoun	10 months ago	
eure	Pronoun	10 months ago	
seine	Pronoun	10 months ago	
werkzeug	Noun	10 months ago	
fahrzeug	Noun	10 months ago	
gebäude	Noun	10 months ago	
brücke	Noun	10 months ago	
park	Noun	10 months ago	
zimmer	Noun	10 months ago	
schule	Noun	10 months ago	
häuser	Noun	10 months ago	
märkte	Noun	10 months ago	
dorf	Noun	10 months ago	
parks	Noun	10 months ago	
land	Noun	10 months ago	
stadt	Noun	10 months ago	
bauen	Verb	10 months ago	
dörfer	Noun	10 months ago	
städte	Noun	10 months ago	
hotels	Noun	10 months ago	
straße	Noun	10 months ago	
schloss	Noun	10 months ago	
bibliotheken	Noun	10 months ago	
restaurant	Noun	10 months ago	
bahnhöfe	Noun	10 months ago	
bahnhof	Noun	10 months ago	
bibliothek	Noun	10 months ago	
hotel	Noun	10 months ago	
restaurants	Noun	10 months ago	
schulen	Noun	10 months ago	
haus	Noun	10 months ago	
gärten	Noun	10 months ago	
garten	Noun	10 months ago	
markt	Noun	10 months ago	
manche	Determiner	10 months ago	
jeder	Determiner	10 months ago	
viele	Determiner	10 months ago	
dieses	Pronoun	10 months ago	
diese	Pronoun	10 months ago	
beide	Determiner	10 months ago	
dies	Pronoun	10 months ago	
bananen	Noun	10 months ago	
eurer	Pronoun	10 months ago	
unser	Pronoun	10 months ago	
euer	Pronoun	10 months ago	
unsere	Pronoun	10 months ago	
berg	Noun	10 months ago	
erde	Noun	10 months ago	
sterne	Noun	10 months ago	
himmel	Noun	10 months ago	
fällt	Verb	10 months ago	
stern	Noun	10 months ago	
fallen	Verb	10 months ago	
lebe	Verb	10 months ago	
meer	Noun	10 months ago	
blume	Noun	10 months ago	
mond	Noun	10 months ago	
blumen	Noun	10 months ago	
feuer	Noun	10 months ago	
berge	Noun	10 months ago	
wind	Noun	10 months ago	
baum	Noun	10 months ago	
bäume	Noun	10 months ago	
knöpfe	Noun	11 months ago	
hose	Noun	11 months ago	
schuhe	Noun	11 months ago	
mäntel	Noun	11 months ago	
jacke	Noun	11 months ago	
knopf	Noun	11 months ago	
schmuck	Noun	11 months ago	
ring	Noun	11 months ago	
fleck	Noun	11 months ago	
taschen	Noun	11 months ago	
kosmetik	Noun	11 months ago	
ringe	Noun	11 months ago	
flecken	Noun	11 months ago	
tasche	Noun	11 months ago	
passen	Verb	11 months ago	
passt	Verb	11 months ago	
jacken	Noun	11 months ago	
kleidung	Noun	11 months ago	
hosen	Noun	11 months ago	
mantel	Noun	11 months ago	
hemd	Noun	11 months ago	
schuh	Noun	11 months ago	
trägt	Verb	11 months ago	
tragen	Verb	11 months ago	
röcke	Noun	11 months ago	
kleid	Noun	11 months ago	
rock	Noun	11 months ago	
trage	Verb	11 months ago	
kleider	Noun	11 months ago	
trägst	Verb	11 months ago	
hut	Noun	11 months ago	
hüte	Noun	11 months ago	
tragt	Verb	11 months ago	
seht	Verb	11 months ago	
schreibe	Verb	11 months ago	
spiele	Verb	11 months ago	
mag	Verb	11 months ago	
fahre	Verb	11 months ago	
fährt	Verb	11 months ago	
mögt	Verb	11 months ago	
brauchst	Verb	11 months ago	
braucht	Verb	11 months ago	
bezahlt	Verb	11 months ago	
bringt	Verb	11 months ago	
bringen	Verb	11 months ago	
rennen	Verb	11 months ago	
kennt	Verb	11 months ago	
fahrt	Verb	11 months ago	
schwimme	Verb	11 months ago	
schreibt	Verb	11 months ago	
hörst	Verb	11 months ago	
hört	Verb	11 months ago	
machen	Verb	11 months ago	
schläfst	Verb	11 months ago	
schlafen	Verb	11 months ago	
macht	Verb	11 months ago	
läufst	Verb	11 months ago	
machst	Verb	11 months ago	
bezahlen	Verb	11 months ago	
reicht	Verb	11 months ago	
beginnst	Verb	11 months ago	
bezahle	Verb	11 months ago	
beginne	Verb	11 months ago	
beginnen	Verb	11 months ago	
bezahlst	Verb	11 months ago	
waschen	Verb	11 months ago	
wäscht	Verb	11 months ago	
brauchen	Verb	11 months ago	
beginnt	Verb	11 months ago	
denke	Verb	11 months ago	
rennt	Verb	11 months ago	
kennst	Verb	11 months ago	
rennst	Verb	11 months ago	
denkst	Verb	11 months ago	
kennen	Verb	11 months ago	
denkt	Verb	11 months ago	
renne	Verb	11 months ago	
fahren	Verb	11 months ago	
denken	Verb	11 months ago	
bringst	Verb	11 months ago	
bringe	Verb	11 months ago	
schwimmst	Verb	11 months ago	
schwimmt	Verb	11 months ago	
siehst	Verb	11 months ago	
sieht	Verb	11 months ago	
lest	Verb	11 months ago	
mögen	Verb	11 months ago	
schreiben	Verb	11 months ago	
magst	Verb	11 months ago	
lesen	Verb	11 months ago	
lernt	Verb	11 months ago	
lerne	Verb	11 months ago	
laufe	Verb	11 months ago	
läuft	Verb	11 months ago	
mache	Verb	11 months ago	
laufen	Verb	11 months ago	
schlafe	Verb	11 months ago	
will	Verb	11 months ago	
spielt	Verb	11 months ago	
geht	Verb	11 months ago	
wollen	Verb	11 months ago	
spielen	Verb	11 months ago	
liest	Verb	11 months ago	
käfer	Noun	11 months ago	
erdbeeren	Noun	11 months ago	
fliegen	Noun	11 months ago	
insekten	Noun	11 months ago	
schweine	Noun	11 months ago	
öl	Noun	11 months ago	
verstehen	Verb	11 months ago	
verstehe	Verb	11 months ago	
versteht	Verb	11 months ago	
verstehst	Verb	11 months ago	
sprichst	Verb	11 months ago	
spreche	Verb	11 months ago	
spricht	Verb	11 months ago	
deutschland	Proper noun	11 months ago	
komme	Verb	11 months ago	
kommt	Verb	11 months ago	
kommst	Verb	11 months ago	
karl	Proper noun	11 months ago	
julia	Proper noun	11 months ago	
heiße	Verb	11 months ago	
heißt	Verb	11 months ago	
lese	Verb	11 months ago	
apfel	Noun	11 months ago	
